##############################
#.23.233.32.3!.23223.23.3.2.2#
#3.22..223.222322.2223222.222#
#2222233.233.121.2222223.2.32#
#.222.23332223.113.2222.3.23.#
#3332.2.2.22233313223.3.222.3#
#.222.22233333112.212.22.3322#
#3.22.22.222221323222.22.2.33#
#.2233.332232.121.222332.33.2#
#222.2223.2.31212.2.22232.222#
#..2.22.232.2.1222.322.222232#
#32232.22332312323222.32.22.3#
#22.32.23.23.112.222222.233.2#
#.3.22.2..322.12.232333322.3.#
#222.2222.223.221..22.22.222.#
#.222222.322.22312.322.223222#
#32.2223.3.322212.22.323332.3#
#.3.22222.223211222.3.2.3..2.#
#..2.2.22..33@.122.22.33.22.2#
##############################
