###########
#.........#
#........%#
#.........#
#.........#
#...##!...#
#....###..#
#.........#
#.........#
#.@.......#
###########