##############################
#.23.233.32.32.23223123.3.2.2#
#3.221.223.32.32..122...2.222#
#223.233.2331121.222.223.2.32#
#.222.2311123.113...22.2.1123#
#333222.2.22..3313223.3.222.3#
#.222.2.233.13122...2!11.3322#
#3.22331.222.313.3..2.22.2.33#
#..233.332232.121.222....33.2#
#2...2223.2.31.12.2.22..2.222#
#3.2122.232.2.1.22..12.222232#
#3.2311.233.112.23.2..32.22.3#
#22.3.211..3.12.321.322.233.2#
#.3.22.1..32.1.2.231333112.3.#
#2222.321.223.221.122.321212.#
#.222222.322.22312.32211.3222#
#3..@22..3.32..12.22.3.3332.3#
#.3.22222.2212..222.2.211..2.#
#322.2.223...13212.22.33.22.2#
##############################