###########
#...%.....#
#.#########
#.........#
#.........#
#...###@..#
#....###..#
#.........#
#.........#
#.####...!#
###########